   A B C D E F G H I J 
 1|_|O|_|_|_|_|_|_|O|_|
 2|_|_|_|_|_|_|_|_|O|_|
 3|_|_|O|_|_|O|O|_|O|_|
 4|_|_|O|_|_|_|_|_|_|_|
 5|_|_|O|_|_|O|_|_|_|_|
 6|_|_|O|_|_|_|_|_|O|O|
 7|_|_|_|_|_|_|_|_|_|_|
 8|_|_|_|_|O|_|O|_|_|_|
 9|_|O|O|_|O|_|_|_|_|_|
10|_|_|_|_|O|_|_|O|_|_|