   A B C D E F G H I J
 1|_|_|_|_|_|_|O|_|_|_|
 2|_|O|O|O|_|_|_|_|_|_|
 3|_|_|_|_|_|_|_|_|_|_|
 4|O|O|_|_|_|O|O|O|O|_|
 5|_|_|_|O|_|_|_|_|_|_|
 6|_|_|_|_|_|_|_|_|O|_|
 7|_|_|_|O|O|_|_|_|O|_|
 8|_|O|_|_|_|_|_|_|O|_|
 9|_|_|_|O|_|O|_|_|_|_|
10|_|_|_|O|_|_|_|_|_|_|